16
sx.........
xx.xx......
xx.xx.xx...
xx.xx.xx.xx
xx.xx.xx.xx
xx.xx.xx.xx
...xx.xx.xx
......xx.xx
.........xe