8
xxx........
xsx.xxx....
xxx.xxx.xxx
....xxx.xxx
xxx.....xxx
xxx.xxx....
xxx.xxx.xxx
....xxx.xex
........xxx